Beispiele für Aktienabkürzungen:
Tesla – TSLA
Apple – AAPL
Microsoft – MSFT
Amazon – AMZN
Google (Alphabet) – GOOGL (für Class A-Aktien) und GOOG (für Class C-Aktien)
Meta (Facebook) – META
NVIDIA – NVDA
Berkshire Hathaway – BRK.A (für A-Aktien) und BRK.B (für B-Aktien)
Netflix – NFLX
Adobe – ADBE
Intel – INTC
Coca-Cola – KO
Disney – DIS
ExxonMobil – XOM
Walmart – WMT
Johnson & Johnson – JNJ
Visa – V
Pfizer – PFE
McDonald's – MCD
The Home Depot – HD
Nike – NKE
PepsiCo – PEP
PayPal – PYPL
General Electric – GE
Bristol-Myers Squibb – BMY
Lockheed Martin – LMT
Procter & Gamble – PG
AbbVie – ABBV
Tesla – TSLA
AMD (Advanced Micro Devices) – AMD